107
8
9  0  0  0  0  0  0  0  0  0  0  0  0  0  0  0  0  0  0  0  0  0  0  0  0  0  0  0  0  0  0  0  0  0  0  0  0  0  0  0  0  0  0  0  0  0  0  0  0  0  0  0  0  0  0  0  0  0  0  0  0  0  0  0  0  0  0  0  0  0  0  0  0  0  0  0  0  0  0  0  0  0  0  0  0  0  0  0  0  0  0  0  0  0  0  0  9  9  0  0  0  0  0  0  0  0  9
9  0  0  0  0  0  0  0  0  0  0  0  0  0  0  0  0  0  0  0  0  0  0  0  0  0  0  0  0  0  0  0  0  0  0  0  0  0  0  0  0  0  0  0  0  0  0  0  0  0  0  0  0  0  0  0  0  0  0  0  0  0  0  9  9  9  9  9  9  9  9  0  0  0  0  9  9  0  0  0  0  0  0  0  0  0  0  0  0  0  0  0  0  0  0  0  9  9  0  0  0  0  0  0  0  0  9
9  0  0  0  0  0  0  0  0  0  0  0  0  0  0  0  0  0  0  0  0  0  0  0  0  0  0  0  0  0  0  0  0  0  0  0  0  0  0  0  0  0  0  0  0  0  0  0  0  0  0  0  0  0  0  0  0  0  0  0  0  0  0  0  0  0  0  0  0  0  9  9  9  9  9  9  9  0  0  0  0  0  0  0  0  0  0  0  0  0  0  0  0  0  0  0  9  9  0  0  0  0  0  0  0  0  9
9  0  0  0  0  0  0  0  0  0  0  0  0  0  0  0  0  0  0  0  0  0  0  0  0  9  9  9  0  0  0  0  9  9  9  0  0  0  0  0  0  0  0  0  0  0  0  0  0  0  0  0  0  0  0  0  0  0  0  0  0  0  9  9  0  0  0  0  0  0  0  0  0  0  0  0  0  0  0  0  0  0  0  0  0  0  0  0  0  0  0  0  0  0  0  0  9  9  0  0  0  0  0  0  0  0  9
9  0  0  0  0  0  0  0  9  9  0  0  0  0  0  0  0  0  0  0  0  0  0  0  9  9  9  9  0  0  0  0  9  9  9  0  0  0  0  0  0  0  0  0  0  0  0  0  0  0  0  0  0  0  0  0  0  0  0  0  0  0  0  0  0  0  0  0  0  0  0  0  0  0  0  0  0  0  0  0  0  0  0  0  0  0  0  0  0  0  0  0  0  0  0  0  9  9  9  0  0  0  0  0  0  9  9
9  0  0  0  0  0  0  0  9  9  0  0  0  0  0  0  9  0  0  0  0  0  0  9  9  9  9  9  9  9  9  9  9  9  9  0  0  0  0  0  9  9  9  0  0  0  0  0  0  0  0  0  0  0  0  0  0  0  0  0  0   0  0  0  0  9  9  0  0  0  0  0  0  0  0  0  0  0  0  0  0  0  0  0  0  0  0  0  0  0  0  0  0  0  0  0  0  0  0  0  0  0  0  0  0  9  9
9  9  9  9  9  9  9  9  9  9  9  9  9  9  0  0  9  9  9  9  9  9  9  9  9  9  9  9  9  9  9  9  9  9  9  0  0  0  0  0  15 15 15  0  0  0  9  9  9  9  9  9  9  0  0  0  0  0  9  0  0  9  0  0  0  9  9  0  0  0  0  0  0  0  0  0  0  0  0  9  9  9  0  9  0  9  0  9  0  9  9  9  9  9  9  9  9  9  9  9  9  9  9  9  9  9  9
15 15 15 15 15 15 15 15 15 15 15 15 15 15 0  0  15 15 15 15 15 15 15 15 15 15 15 15 15 15 15 15 15 15 15  0  0  0  0  0 15 15 15  0  0  0  9  9  9  9  9  9  9  9  9  9  9  9  9  0  0  9  9  9  9  9  9  0  0  0  0  0  0  0  0  0  0  0  0  15 15 15  0 15 0  15 0  15 0  15 15 15 15 15 15 15 15 15 15 15 15 15 15 15 15 15 15